NOasserts/textures/1.xpm
WEasserts/textures/2.xpm
SOasserts/textures/3.xpm
EAasserts/textures/4.xpm
C135,206,235
F136,123,55
   111111111111111111111111111111
11111000000000011110000000001
10000000000000000000000000001
1000000000000000000000N000001
10000000000000000000000000001
10011100000000111000000000001
10011110000000101000000000001
10011100000000101000000000001
11111100000010101000010000001
100000100000100010001 1000001
11111111000011111000010000001
10000000000000000000000000001
11111000000011111111100000001
11111111111111111111111111111 