NOasserts/textures/1.xpm
WEasserts/textures/2.xpm
SOasserts/textures/3.xpm
EAasserts/textures/4.xpm
C135,206,235
F136,123,5W5

 1111111        11111 111
1100N0011      10000010001
100000001     1000000000001
 1000001     100000000000001
  11011      1000000000000001
   101        1000000100000001
   101         100001 100000001
   101111111111100000100000001
   10000000000000000001000001
   1011111111111000001 10001
   101         100000010111
   101        10000000001
  11011      100000000001
 1000001     10000000001
100000001     10000000001
110000011      1000000001
 1111111        111111111 