NO asserts/textures/q1.xpm
WE asserts/textures/q2.xpm
SO asserts/textures/q3.xpm
EA asserts/textures/q4.xpm

F 0,32,0
C 135,206,235

1111111111111111111111111111
1000000000000110000000000001
1011000000001110000000000001
1110001000000000000000000001
1111011000001110000000000001
1000000110000011101111101111
1111011111111011100000010001
1111011111111011101010010001
1100000010101011100000000001
1000000000000001100000010001
1000000000000001101010010001
11000000101011111011110N0111
111101111110101 101111010001
1111111111111111111111111111