NOasserts/textures/1.xpm
WEasserts/textures/2.xpm
SOasserts/textures/3.xpm
EAasserts/textures/4.xpm
C135,206,235
F136,123,55

11111111111111111111111111111
10000000001100001000011100001
10110000011100000010000010001
10010000000000000000000010001
10110000011100000010000010001
10000000001100000111011110001
11110111111111011100000010001
11110111111111011101010010001
11000000110101011100000010001
10000000000010101100000010001
10000000000001001101010010001
11000000110101011111011110N01
11110111111101011111000000001
11111111111111111111111111111   