NO asserts/textures/q1.xpm
WE asserts/textures/q2.xpm
SO asserts/textures/q3.xpm
EA asserts/textures/q4.xpm

F 0,32,0
C 135,206,235

1111111111111111111111111111
10000000000001N0000000000001
1000000000000100000000000001
1000000000000000000000000001
1000000000000000000000000001
1000000000000000000000000001
1000000000000000000000000001
1000000000000000000000000001
1000000000000000000000000001
1000000000000000000000000001
1000011111100000000011100001
1100011111110000000000000001
1000001111110000000011111111
1111111111111111111111111111