NOasserts/textures/1.xpm
WEasserts/textures/2.xpm
SOasserts/textures/3.xpm
EAasserts/textures/4.xpm
C135,206,235
F136,123,55 
11111111111
11111010111
10001010001 
10000000001 
1000000N001 
11111111111
