NOasserts/textures/1.xpm
WEasserts/textures/2.xpm
SOasserts/textures/3.xpm
EAasserts/textures/4.xpm
C135,206,235
F136,123,55


11111111111
10111110101
10010011111
1011110N001
11111111111

